1 1 1 1 1 1 1 1 1 1 1 1 1 1 1 1 1 1 7 7 7 7 7 7 7 7 7 7 1 1 1 1 1 1 1 1 1 1 1 1 1 1 1 1 1 1 1 1 1 1
1 1 1 1 1 1 1 1 1 1 1 1 1 1 1 1 1 1 7 7 7 7 7 7 7 7 7 7 1 1 1 1 1 1 1 1 1 1 1 1 1 1 1 1 1 1 1 1 1 1
1 1 1 1 1 1 1 1 1 1 1 1 6 1 1 1 1 1 1 1 1 1 1 1 1 1 1 1 1 1 1 1 1 1 1 1 1 1 1 1 1 1 1 1 1 1 1 1 1 1
1 1 1 1 1 1 1 6 6 1 1 1 1 1 1 1 1 1 1 1 1 1 1 1 1 1 1 1 1 1 1 1 1 1 1 1 1 1 1 1 1 1 1 1 1 1 1 1 1 1
1 1 1 1 1 1 1 1 1 1 1 1 1 1 1 1 1 1 1 1 1 1 1 4 4 4 4 4 4 4 4 4 4 4 4 4 4 4 1 1 1 1 1 1 1 1 1 1 1 1
1 1 1 1 6 6 1 1 1 1 1 1 1 1 1 1 1 1 4 4 4 4 4 4 4 4 4 4 4 4 4 4 4 4 4 4 4 4 1 1 1 1 1 1 1 1 1 1 1 1
1 1 1 1 1 1 0 8 0 0 2 2 2 2 2 2 0 0 0 0 0 0 0 0 0 0 0 0 0 0 8 0 0 0 0 0 0 0 0 0 0 0 0 0 1 1 1 1 1 1
1 1 1 1 1 1 0 0 0 0 0 0 0 0 0 0 0 0 0 8 0 0 0 0 0 0 0 0 0 0 0 8 0 0 0 0 0 8 0 0 0 0 0 9 1 1 1 1 1 1
1 1 1 1 1 1 0 0 0 0 0 9 0 0 0 0 0 0 0 0 0 0 0 0 9 9 0 0 0 0 0 0 0 0 0 0 0 0 0 0 0 0 0 0 5 5 5 5 5 5
1 1 1 1 1 1 0 0 0 0 0 0 0 0 0 0 0 0 0 0 0 0 0 0 8 0 0 0 0 0 0 0 9 0 0 0 0 0 0 0 8 0 0 0 5 5 5 5 1 1
1 1 1 1 1 1 0 0 0 3 3 3 3 3 0 0 0 0 0 0 0 2 2 2 2 2 2 2 2 0 0 0 0 0 0 0 0 0 0 0 0 0 0 0 1 1 1 5 5 5
1 1 1 1 1 1 0 0 0 3 3 3 3 3 0 0 0 0 8 0 0 2 2 2 2 2 2 2 2 0 0 10 10 10 0 0 9 9 0 0 0 0 0 0 1 1 1 1 1 1
5 5 5 5 5 5 0 0 0 0 0 0 0 9 9 0 0 0 0 0 0 2 2 2 2 2 2 2 2 0 0 10 10 10 0 0 0 0 0 0 0 0 0 0 5 5 5 1 1 1
5 5 5 5 5 5 0 0 0 0 0 0 0 0 0 0 0 0 0 0 0 2 2 2 2 2 2 2 2 0 0 10 8 10 0 2 2 2 2 2 2 0 0 0 1 1 1 1 1 1
5 5 5 5 5 5 0 0 0 0 0 0 0 0 0 0 0 0 0 0 0 2 2 2 2 2 2 2 2 0 0 10 10 10 0 3 3 3 3 3 3 0 0 0 1 1 1 6 1 1
1 1 1 1 1 6 0 0 2 2 2 2 2 2 0 0 0 0 0 0 0 0 0 0 0 0 0 10 10 10 10 10 10 0 0 2 2 2 2 2 2 0 0 0 1 6 1 1 6 1
6 1 1 1 1 6 0 0 3 3 3 3 3 3 0 0 0 0 0 0 0 0 0 0 0 0 0 10 10 10 10 10 10 0 0 2 2 2 2 2 2 0 0 0 1 6 6 1 1 1
1 1 1 1 1 6 0 0 0 0 0 0 0 0 8 0 0 0 0 0 0 0 0 8 0 0 0 10 10 9 0 0 0 0 0 3 3 3 3 3 3 0 0 0 1 1 1 1 1 1
1 1 1 1 1 1 0 0 0 0 0 0 0 0 0 0 0 0 0 0 0 0 0 0 0 0 0 10 10 0 0 0 0 0 0 0 0 0 0 0 0 0 0 0 1 1 1 1 1 1
1 1 1 6 1 1 0 0 0 0 8 0 0 0 9 0 0 0 0 0 2 2 2 2 2 2 2 9 9 10 0 0 0 8 0 0 0 0 0 0 0 0 0 0 1 1 1 1 1 1
1 1 1 1 1 1 0 0 0 0 0 0 0 0 0 0 0 0 0 0 2 2 2 2 2 2 2 2 2 0 0 0 0 0 0 0 3 3 3 3 3 3 3 3 1 1 1 1 1 1
1 1 1 1 1 1 2 2 2 2 2 2 0 9 9 0 0 0 0 0 0 0 0 0 0 0 0 0 0 0 0 0 0 0 0 0 3 3 3 3 3 3 3 3 1 1 6 1 1 1
1 6 1 6 1 1 2 2 2 2 2 2 0 0 0 0 0 0 0 0 0 0 0 0 0 0 0 0 0 0 0 0 0 0 0 0 3 3 3 3 3 3 3 3 1 1 1 1 1 1
1 1 1 1 1 1 2 2 2 2 2 2 0 0 0 0 0 0 0 0 0 0 0 0 0 0 9 0 0 0 0 8 0 0 0 0 3 3 3 3 3 3 3 3 1 1 1 5 5 5
1 1 1 1 1 1 0 0 0 8 0 0 0 0 0 0 0 0 0 0 0 0 0 8 0 0 0 0 0 0 0 0 0 0 0 0 3 3 3 3 3 3 3 3 1 6 1 5 5 5
1 1 1 6 1 1 0 9 0 0 0 0 0 0 0 0 0 8 0 0 0 0 0 0 0 0 0 0 0 0 0 0 0 0 0 0 0 0 0 0 0 0 0 0 1 6 1 5 5 5
1 1 1 1 1 1 0 0 0 0 0 0 9 0 0 0 0 0 0 0 0 0 2 2 2 2 2 2 0 0 0 0 0 9 9 0 0 0 0 0 0 0 0 0 1 1 1 5 5 5
1 1 1 1 1 6 10 10 10 10 10 0 0 0 0 0 0 0 9 0 0 0 0 0 0 0 0 0 0 0 0 0 0 0 0 0 0 0 0 0 0 0 0 0 1 1 1 1 1 1
1 1 1 1 1 1 0 0 0 2 10 10 2 2 2 0 0 0 0 0 0 0 0 0 0 0 0 0 0 0 0 0 0 0 0 0 0 0 0 0 8 0 0 0 1 1 1 1 1 1
1 1 1 1 1 1 0 0 0 0 10 10 0 0 0 0 0 0 0 0 0 0 0 0 0 0 0 0 0 0 0 0 0 0 0 0 0 0 0 0 0 0 0 0 1 1 1 6 1 1
1 1 7 7 1 1 0 0 0 0 10 10 10 10 10 0 0 0 0 8 0 0 0 0 0 8 0 0 0 0 0 0 0 0 8 0 0 0 0 0 9 0 0 0 1 1 1 6 1 1
1 1 1 6 1 1 0 0 0 0 0 0 0 0 0 0 0 0 0 0 0 0 0 0 0 0 0 0 0 0 0 0 0 0 0 0 0 0 0 0 0 0 0 0 1 6 1 1 1 1
1 1 6 1 1 1 0 0 8 0 0 3 3 3 3 3 3 0 0 0 0 0 0 2 2 2 2 2 2 0 0 0 0 0 0 0 0 0 0 0 0 0 0 0 1 1 1 1 1 1
1 1 1 1 1 1 0 0 0 0 0 3 3 3 3 3 3 0 0 0 0 0 0 2 2 2 2 2 2 0 0 0 0 0 0 0 0 2 2 2 2 2 2 0 1 1 6 1 1 1
1 1 6 1 1 1 0 0 9 0 0 0 0 0 0 0 0 0 0 0 0 8 0 2 2 2 2 2 2 0 0 0 0 0 0 0 0 2 2 2 2 2 2 0 1 1 1 1 1 1
1 1 1 1 1 6 0 0 0 0 0 0 0 0 0 0 0 0 0 0 0 0 0 2 2 2 2 2 2 0 0 0 0 0 0 0 0 3 3 3 3 3 3 0 1 1 1 1 1 1
1 1 1 1 1 1 0 0 0 8 0 0 0 0 0 0 0 0 0 0 0 0 0 2 2 2 2 2 2 0 0 0 0 0 0 10 10 3 3 3 3 3 3 0 1 1 1 1 1 1
1 1 1 1 1 1 0 0 0 0 0 0 0 0 0 0 8 0 0 0 0 0 0 2 2 2 2 2 2 0 0 0 0 0 0 10 10 10 10 10 3 3 3 0 1 1 6 1 1 1
7 7 7 1 1 1 0 0 0 0 0 0 0 0 0 0 0 0 0 0 0 0 0 0 0 0 0 0 8 0 0 0 0 0 0 0 0 0 10 10 10 10 10 10 1 1 1 1 1 6
7 7 7 1 1 1 2 2 2 2 2 2 2 0 0 0 0 0 0 0 0 0 0 0 0 0 0 0 0 0 0 0 0 0 0 0 0 0 10 10 10 10 10 10 1 1 1 1 1 1
7 7 7 1 1 1 2 2 2 2 2 2 2 0 9 9 0 0 8 0 0 0 0 0 0 0 0 0 0 0 0 0 0 0 0 9 0 0 0 8 0 0 0 0 1 1 1 1 1 1
7 7 7 1 1 1 2 2 2 2 2 2 2 0 0 0 0 0 0 0 0 0 0 0 0 8 0 0 0 0 0 0 0 0 0 0 0 0 0 0 0 0 0 0 1 1 1 1 6 1
1 1 1 1 1 1 3 3 3 3 3 3 3 0 0 0 0 0 0 0 0 0 0 0 8 0 0 0 0 0 0 0 0 0 0 0 0 0 0 0 0 0 0 0 1 1 6 1 1 1
1 1 1 1 1 1 3 3 3 3 3 3 3 0 0 0 0 0 0 0 0 0 0 0 0 0 0 0 0 0 0 0 0 0 0 0 0 0 0 0 0 0 9 9 1 1 1 1 1 1
1 1 1 1 1 1 1 1 1 1 1 1 1 1 1 1 1 1 7 7 7 7 7 7 7 7 7 7 1 1 1 1 1 1 1 1 1 1 1 1 1 6 1 1 1 1 1 1 1 1
1 1 1 1 1 1 1 1 1 1 1 1 1 1 1 1 1 1 7 7 7 7 7 7 7 7 7 7 1 1 1 1 1 1 1 1 6 1 1 1 1 1 1 1 1 1 1 1 1 1
1 1 6 1 1 1 1 1 1 1 6 1 1 1 1 1 1 1 1 1 1 1 1 6 1 1 1 1 1 1 1 1 1 6 1 1 1 1 1 6 1 1 1 1 1 6 6 1 1 1
1 1 1 1 1 1 1 6 1 1 1 1 1 6 1 1 1 1 1 1 6 1 1 1 1 1 6 1 1 1 1 1 1 1 1 1 1 1 1 1 1 1 1 1 1 1 1 1 1 1
1 1 1 1 6 1 1 1 1 1 1 1 1 1 1 1 1 1 6 1 1 1 1 1 1 1 1 1 1 6 1 1 1 1 1 1 6 6 1 1 1 1 1 1 1 1 1 1 1 1
1 1 1 1 1 1 1 1 1 1 1 1 1 1 1 1 1 1 1 1 1 1 1 1 1 1 1 1 1 1 1 1 1 1 1 1 1 1 1 1 1 1 1 1 1 1 1 1 1 1