16 16 16 16 16 16 16 16 16 16 16 16 16 16 16 16 16 16 7 7 7 7 7 7 7 7 7 7 16 16 16 16 16 16 16 16 16 16 16 16 16 16 16 16 16 16 16 16 16 16
16 16 16 16 16 16 16 16 16 16 16 16 16 16 16 16 16 16 7 7 7 7 7 7 7 7 7 7 16 16 16 16 16 16 16 16 16 16 16 16 16 16 16 16 16 16 16 16 16 16
16 16 16 16 16 16 16 16 16 16 16 16 6 16 16 16 16 16 16 16 16 16 16 16 16 16 16 16 16 16 16 16 16 16 16 16 16 16 16 16 16 16 16 16 16 16 16 16 16 16
16 16 16 16 16 16 16 6 6 16 16 16 16 16 16 16 16 16 16 16 16 16 16 16 16 16 16 16 16 16 16 16 16 16 16 16 16 16 16 16 16 16 16 16 16 16 16 16 16 16
16 16 16 16 16 16 16 16 16 16 16 16 16 16 16 16 16 16 16 16 16 16 16 4 4 4 4 4 4 4 4 4 4 4 4 4 4 4 16 16 16 16 16 16 16 16 16 16 16 16
16 16 16 16 6 6 16 16 16 16 16 16 16 16 16 16 16 16 4 4 4 4 4 4 4 4 4 4 4 4 4 4 4 4 4 4 4 4 16 16 16 16 16 16 16 16 16 16 16 16
16 16 16 16 16 16 9 8 9 9 12 12 12 12 12 12 9 9 9 9 9 9 9 9 9 9 9 9 9 9 9 9 9 9 9 9 9 9 9 9 9 9 9 9 16 16 16 16 16 16
16 16 16 16 16 16 9 9 9 9 9 9 9 9 9 9 9 9 9 9 9 9 9 9 9 9 9 9 9 9 9 9 9 9 9 9 9 9 9 9 9 9 9 9 16 16 16 16 16 16
16 16 16 16 16 16 9 9 9 9 9 9 9 9 9 9 9 9 9 9 9 9 9 9 9 9 9 9 9 9 9 9 9 9 9 9 9 9 9 9 9 9 9 9 5 5 5 5 5 5
16 16 16 16 16 16 9 9 9 9 9 9 9 9 9 9 9 9 9 9 9 9 9 9 9 9 9 9 9 9 9 9 9 9 9 9 9 9 9 9 9 9 9 9 5 5 5 5 16 16
16 16 16 16 16 16 9 9 9 9 9 9 9 9 9 9 9 9 9 9 9 9 9 9 9 9 9 9 9 9 9 9 9 9 9 9 9 9 9 9 9 9 9 9 16 16 16 5 5 5
16 16 16 16 16 16 9 8 9 9 12 12 12 12 12 12 9 9 9 9 9 9 9 9 9 9 9 9 9 9 9 9 9 9 9 9 9 9 9 9 9 9 9 9 16 16 16 16 16 16
5 5 5 5 5 5 9 9 9 9 9 9 9 9 9 9 9 9 9 9 9 9 9 9 9 9 9 9 9 9 9 9 9 9 9 9 9 9 9 9 9 9 9 9 16 16 16 5 5 5
5 5 5 5 5 5 9 9 9 9 9 9 9 9 9 9 9 9 9 9 9 12 12 12 12 12 12 12 12 9 9 10 8 10 9 12 12 12 12 12 12 9 9 9 16 16 16 16 16 16
5 5 5 5 5 5 9 9 9 9 9 9 9 9 9 9 9 9 9 9 9 12 12 12 12 12 12 12 12 9 9 10 10 10 9 13 13 13 13 13 13 9 9 9 16 16 16 6 16 16
16 16 16 16 16 6 9 9 12 12 12 12 12 12 9 9 9 9 9 9 9 9 9 9 9 9 9 10 10 10 10 10 10 9 9 12 12 12 12 12 12 9 9 9 16 6 16 16 6 16
6 16 16 16 16 6 9 9 13 13 13 13 13 13 9 9 9 9 9 9 9 9 9 9 9 9 9 10 10 10 10 10 10 9 9 12 12 12 12 12 12 9 9 9 16 6 6 16 16 16
16 16 16 16 16 6 9 9 9 9 9 9 9 9 8 9 9 9 9 9 9 9 9 8 9 9 9 10 10 9 9 9 9 9 9 13 13 13 13 13 13 9 9 9 16 16 16 16 16 16
16 16 16 16 16 16 9 9 9 9 9 9 9 9 9 9 9 9 9 9 9 9 9 9 9 9 9 9 10 10 9 9 9 9 9 9 9 9 9 9 9 9 9 9 9 16 16 16 16 16 16
16 16 16 6 16 16 9 9 9 9 8 9 9 9 9 9 9 9 9 9 12 12 12 12 12 12 12 9 9 10 9 9 9 8 9 9 9 9 9 9 9 9 9 9 16 16 16 16 16 16
16 16 16 16 16 16 9 9 9 9 9 9 9 9 9 9 9 9 9 9 12 12 12 12 12 12 12 12 12 9 9 9 9 9 9 9 13 13 13 13 13 13 13 13 16 16 16 16 16 16
16 16 16 16 16 16 12 12 12 12 12 12 9 9 9 9 9 9 9 9 9 9 9 9 9 9 9 9 9 9 9 9 9 9 9 9 9 13 13 13 13 13 13 13 13 16 16 6 16 16 16
16 6 16 6 16 16 12 12 12 12 12 12 9 9 9 9 9 9 9 9 9 9 9 9 9 9 9 9 9 9 9 9 9 9 9 9 13 13 13 13 13 13 13 13 16 16 16 16 16 16
16 16 16 16 16 16 12 12 12 12 12 12 9 9 9 9 9 9 9 9 9 9 9 9 9 9 9 9 9 9 9 9 9 9 9 9 13 13 13 13 13 13 13 13 16 16 16 5 5 5
16 16 16 16 16 16 9 9 9 8 9 9 9 9 9 9 9 9 9 9 9 9 9 8 9 9 9 9 9 9 9 9 9 9 9 9 13 13 13 13 13 13 13 13 16 6 16 5 5 5
16 16 16 6 16 16 9 9 9 9 9 9 9 9 9 9 9 8 9 9 9 9 9 9 9 9 9 9 9 9 9 9 9 9 9 9 9 9 9 9 9 9 9 9 16 6 16 5 5 5
16 16 16 16 16 16 9 9 9 9 9 9 9 9 9 9 9 9 9 9 9 9 12 12 12 12 12 12 9 9 9 9 9 9 9 9 9 9 9 9 9 9 9 9 16 16 16 5 5 5
16 16 16 16 16 6 10 10 10 10 10 9 9 9 9 9 9 9 9 9 9 9 9 9 9 9 9 9 9 9 9 9 9 9 9 9 9 9 9 9 9 9 9 9 16 16 16 16 16 16
16 16 16 16 16 16 9 9 9 12 10 10 12 12 12 9 9 9 9 9 9 9 9 9 9 9 9 9 9 9 9 9 9 9 9 9 9 9 9 9 8 9 9 9 16 16 16 16 16 16
16 16 16 16 16 16 9 9 9 9 10 10 9 9 9 9 9 9 9 9 9 9 9 9 9 9 9 9 9 9 9 9 9 9 9 9 9 9 9 9 9 9 9 9 16 16 16 6 16 16
16 16 7 7 16 16 9 9 9 9 10 10 10 10 10 9 9 9 9 8 9 9 9 9 9 8 9 9 9 9 9 9 9 9 8 9 9 9 9 9 9 9 9 9 16 16 16 6 16 16
16 16 16 6 16 16 9 9 9 9 9 9 9 9 9 9 9 9 9 9 9 9 9 9 9 9 9 9 9 9 9 9 9 9 9 9 9 9 9 9 9 9 9 9 16 6 16 16 16 16
16 16 6 16 16 16 9 9 8 9 9 13 13 13 13 13 13 9 9 9 9 9 9 12 12 12 12 12 12 9 9 9 9 9 9 9 9 9 9 9 9 9 9 9 16 16 16 16 16 16
16 16 16 16 16 16 9 9 9 9 9 13 13 13 13 13 13 9 9 9 9 9 9 12 12 12 12 12 12 9 9 9 9 9 9 9 9 12 12 12 12 12 12 9 16 16 6 16 16 16
16 16 6 16 16 16 9 9 9 9 9 9 9 9 9 9 9 9 9 9 9 8 9 12 12 12 12 12 12 9 9 9 9 9 9 9 9 12 12 12 12 12 12 9 16 16 16 16 16 16
16 16 16 16 16 6 9 9 9 9 9 9 9 9 9 9 9 9 9 9 9 9 9 12 12 12 12 12 12 9 9 9 9 9 9 9 9 13 13 13 13 13 13 9 16 16 16 16 16 16
16 16 16 16 16 16 9 9 9 8 9 9 9 9 9 9 9 9 9 9 9 9 9 12 12 12 12 12 12 9 9 9 9 9 9 10 10 13 13 13 13 13 13 9 16 16 16 16 16 16
16 16 16 16 16 16 9 9 9 9 9 9 9 9 9 9 8 9 9 9 9 9 9 12 12 12 12 12 12 9 9 9 9 9 9 10 10 10 10 10 13 13 13 9 16 16 6 16 16 16
7 7 7 16 16 16 9 9 9 9 9 9 9 9 9 9 9 9 9 9 9 9 9 9 9 9 9 9 9 9 9 9 9 9 9 9 9 9 10 10 10 10 10 10 16 16 16 16 16 6
7 7 7 16 16 16 12 12 12 12 12 12 12 9 9 9 9 9 9 9 9 9 9 9 9 9 9 9 9 9 9 9 9 9 9 9 9 9 10 10 10 10 10 10 16 16 16 16 16 16
7 7 7 16 16 16 12 12 12 12 12 12 12 9 9 9 9 9 8 9 9 9 9 9 9 9 9 9 9 9 9 9 9 9 9 9 9 9 9 8 9 9 9 9 16 16 16 16 16 16
7 7 7 16 16 16 12 12 12 12 12 12 12 9 9 9 9 9 9 9 9 9 9 9 9 8 9 9 9 9 9 9 9 9 9 9 9 9 9 9 9 9 9 9 16 16 16 16 6 16
16 16 16 16 16 16 13 13 13 13 13 13 13 9 9 9 9 9 9 9 9 9 9 9 8 9 9 9 9 9 9 9 9 9 9 9 9 9 9 9 9 9 9 9 16 16 6 16 16 16
16 16 16 16 16 16 13 13 13 13 13 13 13 9 9 9 9 9 9 9 9 9 9 9 9 9 9 9 9 9 9 9 9 9 9 9 9 9 9 9 9 9 9 9 16 16 16 16 16 16
16 16 16 16 16 16 16 16 16 16 16 16 16 16 16 16 16 16 7 7 7 7 7 7 7 7 7 7 16 16 16 16 16 16 16 16 16 16 16 16 16 6 16 16 16 16 16 16 16 16
16 16 16 16 16 16 16 16 16 16 16 16 16 16 16 16 16 16 7 7 7 7 7 7 7 7 7 7 16 16 16 16 16 16 16 16 6 16 16 16 16 16 16 16 16 16 16 16 16 16
16 16 6 16 16 16 16 16 16 16 6 16 16 16 16 16 16 16 16 16 16 16 16 6 16 16 16 16 16 16 16 16 16 6 16 16 16 16 16 6 16 16 16 16 16 6 6 16 16 16
16 16 16 16 16 16 16 6 16 16 16 16 16 6 16 16 16 16 16 16 6 16 16 16 16 16 6 16 16 16 16 16 16 16 16 16 16 16 16 16 16 16 16 16 16 16 16 16 16 16
16 16 16 16 6 16 16 16 16 16 16 16 16 16 16 16 16 16 6 16 16 16 16 16 16 16 16 16 16 6 16 16 16 16 16 16 6 6 16 16 16 16 16 16 16 16 16 16 16 16
16 16 16 16 16 16 16 16 16 16 16 16 16 16 16 16 16 16 16 16 16 16 16 16 16 16 16 16 16 16 16 16 16 16 16 16 16 16 16 16 16 16 16 16 16 16 16 16 16 16
