1 1 1 1 1 1 1 1 1 1 1 1 1 1 1 1 1 1 7 7 7 7 7 7 7 7 7 7 1 1 1 1 1 1 1 1 1 1 1 1 1 1 1 1 1 1 1 1 1 1
1 1 1 1 1 1 1 1 1 1 1 1 1 1 1 1 1 1 7 7 7 7 7 7 7 7 7 7 1 1 1 1 1 1 1 1 1 1 1 1 1 1 1 1 1 1 1 1 1 1
1 1 1 1 1 1 1 1 1 1 1 1 6 1 1 1 1 1 1 1 1 1 1 1 1 1 1 1 1 1 1 1 1 1 1 1 1 1 1 1 1 1 1 1 1 1 1 1 1 1
1 1 1 1 1 1 1 6 6 1 1 1 1 1 1 1 1 1 1 1 1 1 1 1 1 1 1 1 1 1 1 1 1 1 1 1 1 1 1 1 1 1 1 1 1 1 1 1 1 1
1 1 1 1 1 1 1 1 1 1 1 1 1 1 1 1 1 1 1 1 1 1 1 4 4 4 4 4 4 4 4 4 4 4 4 4 4 4 1 1 1 1 1 1 1 1 1 1 1 1
1 1 1 1 6 6 1 1 1 1 1 1 1 1 1 1 1 1 4 4 4 4 4 4 4 4 4 4 4 4 4 4 4 4 4 4 4 4 1 1 1 1 1 1 1 1 1 1 1 1
1 1 1 1 1 1 9 8 9 9 12 12 12 12 12 12 9 9 9 9 9 9 9 9 9 9 9 9 9 9 9 9 9 9 9 9 9 9 9 9 9 9 9 9 1 1 1 1 1 1
1 1 1 1 1 1 9 9 9 9 9 9 9 9 9 9 9 9 9 9 9 9 9 9 9 9 9 9 9 9 9 9 9 9 9 9 9 9 9 9 9 9 9 9 1 1 1 1 1 1
1 1 1 1 1 1 9 9 9 9 9 9 9 9 9 9 9 9 9 9 9 9 9 9 9 9 9 9 9 9 9 9 9 9 9 9 9 9 9 9 9 9 9 9 5 5 5 5 5 5
1 1 1 1 1 1 9 9 9 9 9 9 9 9 9 9 9 9 9 9 9 9 9 9 9 9 9 9 9 9 9 9 9 9 9 9 9 9 9 9 9 9 9 9 5 5 5 5 1 1
1 1 1 1 1 1 9 9 9 9 9 9 9 9 9 9 9 9 9 9 9 9 9 9 9 9 9 9 9 9 9 9 9 9 9 9 9 9 9 9 9 9 9 9 1 1 1 5 5 5
1 1 1 1 1 1 9 8 9 9 12 12 12 12 12 12 9 9 9 9 9 9 9 9 9 9 9 9 9 9 9 9 9 9 9 9 9 9 9 9 9 9 9 9 1 1 1 1 1 1
5 5 5 5 5 5 9 9 9 9 9 9 9 9 9 9 9 9 9 9 9 9 9 9 9 9 9 9 9 9 9 9 9 9 9 9 9 9 9 9 9 9 9 9 1 1 1 5 5 5
5 5 5 5 5 5 9 9 9 9 9 9 9 9 9 9 9 9 9 9 9 12 12 12 12 12 12 12 12 9 9 10 8 10 9 12 12 12 12 12 12 9 9 9 1 1 1 1 1 1
5 5 5 5 5 5 9 9 9 9 9 9 9 9 9 9 9 9 9 9 9 12 12 12 12 12 12 12 12 9 9 10 10 10 9 13 13 13 13 13 13 9 9 9 1 1 1 6 1 1
1 1 1 1 1 6 9 9 12 12 12 12 12 12 9 9 9 9 9 9 9 9 9 9 9 9 9 10 10 10 10 10 10 9 9 12 12 12 12 12 12 9 9 9 1 6 1 1 6 1
6 1 1 1 1 6 9 9 13 13 13 13 13 13 9 9 9 9 9 9 9 9 9 9 9 9 9 10 10 10 10 10 10 9 9 12 12 12 12 12 12 9 9 9 1 6 6 1 1 1
1 1 1 1 1 6 9 9 9 9 9 9 9 9 8 9 9 9 9 9 9 9 9 8 9 9 9 10 10 9 9 9 9 9 9 13 13 13 13 13 13 9 9 9 1 1 1 1 1 1
1 1 1 1 1 1 9 9 9 9 9 9 9 9 9 9 9 9 9 9 9 9 9 9 9 9 9 9 10 10 9 9 9 9 9 9 9 9 9 9 9 9 9 9 9 1 1 1 1 1 1
1 1 1 6 1 1 9 9 9 9 8 9 9 9 9 9 9 9 9 9 12 12 12 12 12 12 12 9 9 10 9 9 9 8 9 9 9 9 9 9 9 9 9 9 1 1 1 1 1 1
1 1 1 1 1 1 9 9 9 9 9 9 9 9 9 9 9 9 9 9 12 12 12 12 12 12 12 12 12 9 9 9 9 9 9 9 13 13 13 13 13 13 13 13 1 1 1 1 1 1
1 1 1 1 1 1 12 12 12 12 12 12 9 9 9 9 9 9 9 9 9 9 9 9 9 9 9 9 9 9 9 9 9 9 9 9 9 13 13 13 13 13 13 13 13 1 1 6 1 1 1
1 6 1 6 1 1 12 12 12 12 12 12 9 9 9 9 9 9 9 9 9 9 9 9 9 9 9 9 9 9 9 9 9 9 9 9 13 13 13 13 13 13 13 13 1 1 1 1 1 1
1 1 1 1 1 1 12 12 12 12 12 12 9 9 9 9 9 9 9 9 9 9 9 9 9 9 9 9 9 9 9 9 9 9 9 9 13 13 13 13 13 13 13 13 1 1 1 5 5 5
1 1 1 1 1 1 9 9 9 8 9 9 9 9 9 9 9 9 9 9 9 9 9 8 9 9 9 9 9 9 9 9 9 9 9 9 13 13 13 13 13 13 13 13 1 6 1 5 5 5
1 1 1 6 1 1 9 9 9 9 9 9 9 9 9 9 9 8 9 9 9 9 9 9 9 9 9 9 9 9 9 9 9 9 9 9 9 9 9 9 9 9 9 9 1 6 1 5 5 5
1 1 1 1 1 1 9 9 9 9 9 9 9 9 9 9 9 9 9 9 9 9 12 12 12 12 12 12 9 9 9 9 9 9 9 9 9 9 9 9 9 9 9 9 1 1 1 5 5 5
1 1 1 1 1 6 10 10 10 10 10 9 9 9 9 9 9 9 9 9 9 9 9 9 9 9 9 9 9 9 9 9 9 9 9 9 9 9 9 9 9 9 9 9 1 1 1 1 1 1
1 1 1 1 1 1 9 9 9 12 10 10 12 12 12 9 9 9 9 9 9 9 9 9 9 9 9 9 9 9 9 9 9 9 9 9 9 9 9 9 8 9 9 9 1 1 1 1 1 1
1 1 1 1 1 1 9 9 9 9 10 10 9 9 9 9 9 9 9 9 9 9 9 9 9 9 9 9 9 9 9 9 9 9 9 9 9 9 9 9 9 9 9 9 1 1 1 6 1 1
1 1 7 7 1 1 9 9 9 9 10 10 10 10 10 9 9 9 9 8 9 9 9 9 9 8 9 9 9 9 9 9 9 9 8 9 9 9 9 9 9 9 9 9 1 1 1 6 1 1
1 1 1 6 1 1 9 9 9 9 9 9 9 9 9 9 9 9 9 9 9 9 9 9 9 9 9 9 9 9 9 9 9 9 9 9 9 9 9 9 9 9 9 9 1 6 1 1 1 1
1 1 6 1 1 1 9 9 8 9 9 13 13 13 13 13 13 9 9 9 9 9 9 12 12 12 12 12 12 9 9 9 9 9 9 9 9 9 9 9 9 9 9 9 1 1 1 1 1 1
1 1 1 1 1 1 9 9 9 9 9 13 13 13 13 13 13 9 9 9 9 9 9 12 12 12 12 12 12 9 9 9 9 9 9 9 9 12 12 12 12 12 12 9 1 1 6 1 1 1
1 1 6 1 1 1 9 9 9 9 9 9 9 9 9 9 9 9 9 9 9 8 9 12 12 12 12 12 12 9 9 9 9 9 9 9 9 12 12 12 12 12 12 9 1 1 1 1 1 1
1 1 1 1 1 6 9 9 9 9 9 9 9 9 9 9 9 9 9 9 9 9 9 12 12 12 12 12 12 9 9 9 9 9 9 9 9 13 13 13 13 13 13 9 1 1 1 1 1 1
1 1 1 1 1 1 9 9 9 8 9 9 9 9 9 9 9 9 9 9 9 9 9 12 12 12 12 12 12 9 9 9 9 9 9 10 10 13 13 13 13 13 13 9 1 1 1 1 1 1
1 1 1 1 1 1 9 9 9 9 9 9 9 9 9 9 8 9 9 9 9 9 9 12 12 12 12 12 12 9 9 9 9 9 9 10 10 10 10 10 13 13 13 9 1 1 6 1 1 1
7 7 7 1 1 1 9 9 9 9 9 9 9 9 9 9 9 9 9 9 9 9 9 9 9 9 9 9 9 9 9 9 9 9 9 9 9 9 10 10 10 10 10 10 1 1 1 1 1 6
7 7 7 1 1 1 12 12 12 12 12 12 12 9 9 9 9 9 9 9 9 9 9 9 9 9 9 9 9 9 9 9 9 9 9 9 9 9 10 10 10 10 10 10 1 1 1 1 1 1
7 7 7 1 1 1 12 12 12 12 12 12 12 9 9 9 9 9 8 9 9 9 9 9 9 9 9 9 9 9 9 9 9 9 9 9 9 9 9 8 9 9 9 9 1 1 1 1 1 1
7 7 7 1 1 1 12 12 12 12 12 12 12 9 9 9 9 9 9 9 9 9 9 9 9 8 9 9 9 9 9 9 9 9 9 9 9 9 9 9 9 9 9 9 1 1 1 1 6 1
1 1 1 1 1 1 13 13 13 13 13 13 13 9 9 9 9 9 9 9 9 9 9 9 8 9 9 9 9 9 9 9 9 9 9 9 9 9 9 9 9 9 9 9 1 1 6 1 1 1
1 1 1 1 1 1 13 13 13 13 13 13 13 9 9 9 9 9 9 9 9 9 9 9 9 9 9 9 9 9 9 9 9 9 9 9 9 9 9 9 9 9 9 9 1 1 1 1 1 1
1 1 1 1 1 1 1 1 1 1 1 1 1 1 1 1 1 1 7 7 7 7 7 7 7 7 7 7 1 1 1 1 1 1 1 1 1 1 1 1 1 6 1 1 1 1 1 1 1 1
1 1 1 1 1 1 1 1 1 1 1 1 1 1 1 1 1 1 7 7 7 7 7 7 7 7 7 7 1 1 1 1 1 1 1 1 6 1 1 1 1 1 1 1 1 1 1 1 1 1
1 1 6 1 1 1 1 1 1 1 6 1 1 1 1 1 1 1 1 1 1 1 1 6 1 1 1 1 1 1 1 1 1 6 1 1 1 1 1 6 1 1 1 1 1 6 6 1 1 1
1 1 1 1 1 1 1 6 1 1 1 1 1 6 1 1 1 1 1 1 6 1 1 1 1 1 6 1 1 1 1 1 1 1 1 1 1 1 1 1 1 1 1 1 1 1 1 1 1 1
1 1 1 1 6 1 1 1 1 1 1 1 1 1 1 1 1 1 6 1 1 1 1 1 1 1 1 1 1 6 1 1 1 1 1 1 6 6 1 1 1 1 1 1 1 1 1 1 1 1
1 1 1 1 1 1 1 1 1 1 1 1 1 1 1 1 1 1 1 1 1 1 1 1 1 1 1 1 1 1 1 1 1 1 1 1 1 1 1 1 1 1 1 1 1 1 1 1 1 1