15 15 15 15 15 15 15 15 15 15 15 15 15 15 15 15 15 15 7 7 7 7 7 7 7 7 7 7 15 15 15 15 15 15 15 15 15 15 15 15 15 15 15 15 15 15 15 15 15 15
15 15 15 15 15 15 15 15 15 15 15 15 15 15 15 15 15 15 7 7 7 7 7 7 7 7 7 7 15 15 15 15 15 15 15 15 15 15 15 15 15 15 15 15 15 15 15 15 15 15
15 15 15 15 15 15 15 15 15 15 15 15 6 15 15 15 15 15 15 15 15 15 15 15 15 15 15 15 15 15 15 15 15 15 15 15 15 15 15 15 15 15 15 15 15 15 15 15 15 15
15 15 15 15 15 15 15 6 6 15 15 15 15 15 15 15 15 15 15 15 15 15 15 15 15 15 15 15 15 15 15 15 15 15 15 15 15 15 15 15 15 15 15 15 15 15 15 15 15 15
15 15 15 15 15 15 15 15 15 15 15 15 15 15 15 15 15 15 15 15 15 15 15 4 4 4 4 4 4 4 4 4 4 4 4 4 4 4 15 15 15 15 15 15 15 15 15 15 15 15
15 15 15 15 6 6 15 15 15 15 15 15 15 15 15 15 15 15 4 4 4 4 4 4 4 4 4 4 4 4 4 4 4 4 4 4 4 4 15 15 15 15 15 15 15 15 15 15 15 15
15 15 15 15 15 15 14 8 14 14 12 12 12 12 12 12 14 14 14 14 14 14 14 14 14 14 14 14 14 14 14 14 14 14 14 14 14 14 14 14 14 14 14 14 15 15 15 15 15 15
15 15 15 15 15 15 14 14 14 14 14 14 14 14 14 14 14 14 14 14 14 14 14 14 14 14 14 14 14 14 14 14 14 14 14 14 14 14 14 14 14 14 14 14 15 15 15 15 15 15
15 15 15 15 15 15 14 14 14 14 14 14 14 14 14 14 14 14 14 14 14 14 14 14 14 14 14 14 14 14 14 14 14 14 14 14 14 14 14 14 14 14 14 14 5 5 5 5 5 5
15 15 15 15 15 15 14 14 14 14 14 14 14 14 14 14 14 14 14 14 14 14 14 14 14 14 14 14 14 14 14 14 14 14 14 14 14 14 14 14 14 14 14 14 5 5 5 5 15 15
15 15 15 15 15 15 14 14 14 14 14 14 14 14 14 14 14 14 14 14 14 14 14 14 14 14 14 14 14 14 14 14 14 14 14 14 14 14 14 14 14 14 14 14 15 15 15 5 5 5
15 15 15 15 15 15 14 8 14 14 12 12 12 12 12 12 14 14 14 14 14 14 14 14 14 14 14 14 14 14 14 14 14 14 14 14 14 14 14 14 14 14 14 14 15 15 15 15 15 15
5 5 5 5 5 5 14 14 14 14 14 14 14 14 14 14 14 14 14 14 14 14 14 14 14 14 14 14 14 14 14 14 14 14 14 14 14 14 14 14 14 14 14 14 15 15 15 5 5 5
5 5 5 5 5 5 14 14 14 14 14 14 14 14 14 14 14 14 14 14 14 12 12 12 12 12 12 12 12 14 14 10 8 10 14 12 12 12 12 12 12 14 14 14 15 15 15 15 15 15
5 5 5 5 5 5 14 14 14 14 14 14 14 14 14 14 14 14 14 14 14 12 12 12 12 12 12 12 12 14 14 10 10 10 14 13 13 13 13 13 13 14 14 14 15 15 15 6 15 15
15 15 15 15 15 6 14 14 12 12 12 12 12 12 14 14 14 14 14 14 14 14 14 14 14 14 14 10 10 10 10 10 10 14 14 12 12 12 12 12 12 14 14 14 15 6 15 15 6 15
6 15 15 15 15 6 14 14 13 13 13 13 13 13 14 14 14 14 14 14 14 14 14 14 14 14 14 10 10 10 10 10 10 14 14 12 12 12 12 12 12 14 14 14 15 6 6 15 15 15
15 15 15 15 15 6 14 14 14 14 14 14 14 14 8 14 14 14 14 14 14 14 14 8 14 14 14 10 10 14 14 14 14 14 14 13 13 13 13 13 13 14 14 14 15 15 15 15 15 15
15 15 15 15 15 15 14 14 14 14 14 14 14 14 14 14 14 14 14 14 14 14 14 14 14 14 14 14 10 10 14 14 14 14 14 14 14 14 14 14 14 14 14 14 14 15 15 15 15 15 15
15 15 15 6 15 15 14 14 14 14 8 14 14 14 14 14 14 14 14 14 12 12 12 12 12 12 12 14 14 10 14 14 14 8 14 14 14 14 14 14 14 14 14 14 15 15 15 15 15 15
15 15 15 15 15 15 14 14 14 14 14 14 14 14 14 14 14 14 14 14 12 12 12 12 12 12 12 12 12 14 14 14 14 14 14 14 13 13 13 13 13 13 13 13 15 15 15 15 15 15
15 15 15 15 15 15 12 12 12 12 12 12 14 14 14 14 14 14 14 14 14 14 14 14 14 14 14 14 14 14 14 14 14 14 14 14 14 13 13 13 13 13 13 13 13 15 15 6 15 15 15
15 6 15 6 15 15 12 12 12 12 12 12 14 14 14 14 14 14 14 14 14 14 14 14 14 14 14 14 14 14 14 14 14 14 14 14 13 13 13 13 13 13 13 13 15 15 15 15 15 15
15 15 15 15 15 15 12 12 12 12 12 12 14 14 14 14 14 14 14 14 14 14 14 14 14 14 14 14 14 14 14 14 14 14 14 14 13 13 13 13 13 13 13 13 15 15 15 5 5 5
15 15 15 15 15 15 14 14 14 8 14 14 14 14 14 14 14 14 14 14 14 14 14 8 14 14 14 14 14 14 14 14 14 14 14 14 13 13 13 13 13 13 13 13 15 6 15 5 5 5
15 15 15 6 15 15 14 14 14 14 14 14 14 14 14 14 14 8 14 14 14 14 14 14 14 14 14 14 14 14 14 14 14 14 14 14 14 14 14 14 14 14 14 14 15 6 15 5 5 5
15 15 15 15 15 15 14 14 14 14 14 14 14 14 14 14 14 14 14 14 14 14 12 12 12 12 12 12 14 14 14 14 14 14 14 14 14 14 14 14 14 14 14 14 15 15 15 5 5 5
15 15 15 15 15 6 10 10 10 10 10 14 14 14 14 14 14 14 14 14 14 14 14 14 14 14 14 14 14 14 14 14 14 14 14 14 14 14 14 14 14 14 14 14 15 15 15 15 15 15
15 15 15 15 15 15 14 14 14 12 10 10 12 12 12 14 14 14 14 14 14 14 14 14 14 14 14 14 14 14 14 14 14 14 14 14 14 14 14 14 8 14 14 14 15 15 15 15 15 15
15 15 15 15 15 15 14 14 14 14 10 10 14 14 14 14 14 14 14 14 14 14 14 14 14 14 14 14 14 14 14 14 14 14 14 14 14 14 14 14 14 14 14 14 15 15 15 6 15 15
15 15 7 7 15 15 14 14 14 14 10 10 10 10 10 14 14 14 14 8 14 14 14 14 14 8 14 14 14 14 14 14 14 14 8 14 14 14 14 14 14 14 14 14 15 15 15 6 15 15
15 15 15 6 15 15 14 14 14 14 14 14 14 14 14 14 14 14 14 14 14 14 14 14 14 14 14 14 14 14 14 14 14 14 14 14 14 14 14 14 14 14 14 14 15 6 15 15 15 15
15 15 6 15 15 15 14 14 8 14 14 13 13 13 13 13 13 14 14 14 14 14 14 12 12 12 12 12 12 14 14 14 14 14 14 14 14 14 14 14 14 14 14 14 15 15 15 15 15 15
15 15 15 15 15 15 14 14 14 14 14 13 13 13 13 13 13 14 14 14 14 14 14 12 12 12 12 12 12 14 14 14 14 14 14 14 14 12 12 12 12 12 12 14 15 15 6 15 15 15
15 15 6 15 15 15 14 14 14 14 14 14 14 14 14 14 14 14 14 14 14 8 14 12 12 12 12 12 12 14 14 14 14 14 14 14 14 12 12 12 12 12 12 14 15 15 15 15 15 15
15 15 15 15 15 6 14 14 14 14 14 14 14 14 14 14 14 14 14 14 14 14 14 12 12 12 12 12 12 14 14 14 14 14 14 14 14 13 13 13 13 13 13 14 15 15 15 15 15 15
15 15 15 15 15 15 14 14 14 8 14 14 14 14 14 14 14 14 14 14 14 14 14 12 12 12 12 12 12 14 14 14 14 14 14 10 10 13 13 13 13 13 13 14 15 15 15 15 15 15
15 15 15 15 15 15 14 14 14 14 14 14 14 14 14 14 8 14 14 14 14 14 14 12 12 12 12 12 12 14 14 14 14 14 14 10 10 10 10 10 13 13 13 14 15 15 6 15 15 15
7 7 7 15 15 15 14 14 14 14 14 14 14 14 14 14 14 14 14 14 14 14 14 14 14 14 14 14 14 14 14 14 14 14 14 14 14 14 10 10 10 10 10 10 15 15 15 15 15 6
7 7 7 15 15 15 12 12 12 12 12 12 12 14 14 14 14 14 14 14 14 14 14 14 14 14 14 14 14 14 14 14 14 14 14 14 14 14 10 10 10 10 10 10 15 15 15 15 15 15
7 7 7 15 15 15 12 12 12 12 12 12 12 14 14 14 14 14 8 14 14 14 14 14 14 14 14 14 14 14 14 14 14 14 14 14 14 14 14 8 14 14 14 14 15 15 15 15 15 15
7 7 7 15 15 15 12 12 12 12 12 12 12 14 14 14 14 14 14 14 14 14 14 14 14 8 14 14 14 14 14 14 14 14 14 14 14 14 14 14 14 14 14 14 15 15 15 15 6 15
15 15 15 15 15 15 13 13 13 13 13 13 13 14 14 14 14 14 14 14 14 14 14 14 8 14 14 14 14 14 14 14 14 14 14 14 14 14 14 14 14 14 14 14 15 15 6 15 15 15
15 15 15 15 15 15 13 13 13 13 13 13 13 14 14 14 14 14 14 14 14 14 14 14 14 14 14 14 14 14 14 14 14 14 14 14 14 14 14 14 14 14 14 14 15 15 15 15 15 15
15 15 15 15 15 15 15 15 15 15 15 15 15 15 15 15 15 15 7 7 7 7 7 7 7 7 7 7 15 15 15 15 15 15 15 15 15 15 15 15 15 6 15 15 15 15 15 15 15 15
15 15 15 15 15 15 15 15 15 15 15 15 15 15 15 15 15 15 7 7 7 7 7 7 7 7 7 7 15 15 15 15 15 15 15 15 6 15 15 15 15 15 15 15 15 15 15 15 15 15
15 15 6 15 15 15 15 15 15 15 6 15 15 15 15 15 15 15 15 15 15 15 15 6 15 15 15 15 15 15 15 15 15 6 15 15 15 15 15 6 15 15 15 15 15 6 6 15 15 15
15 15 15 15 15 15 15 6 15 15 15 15 15 6 15 15 15 15 15 15 6 15 15 15 15 15 6 15 15 15 15 15 15 15 15 15 15 15 15 15 15 15 15 15 15 15 15 15 15 15
15 15 15 15 6 15 15 15 15 15 15 15 15 15 15 15 15 15 6 15 15 15 15 15 15 15 15 15 15 6 15 15 15 15 15 15 6 6 15 15 15 15 15 15 15 15 15 15 15 15
15 15 15 15 15 15 15 15 15 15 15 15 15 15 15 15 15 15 15 15 15 15 15 15 15 15 15 15 15 15 15 15 15 15 15 15 15 15 15 15 15 15 15 15 15 15 15 15 15 15
